' MAP MADE WITH CDN MEDIA STUDIO
                                    
 ÑxxÄxÄxxxxxÄxxxÄxxxÄxxÄxxxxxxÄxxÖ  
 y5 } }1  e8}   yo :y  y     Ryg4y  
 yeeâ  É    ä  Ty   y  y   |  yg y  
xÇxx~   É    ä[ Ü~7á  y[  y  }8Çxx
 y     É É   |[        } [ y     y  
 yXÉ  ä   1 Åx~      ä [  }     y  
 z~S~     É   8xÄxx~    É      y  
 y É      É É     }   |    É     y  
x{       É   |   É É  Üx~   É   {  
 z~äxÄxÖ  T }  1  [ |   [T  É É9zxx
 y TX } } [   äÑ~ [S y  É   É É5 y  
 yd      É   É y É[  }   É É  MNNy  
 z~1xÖ É É É  }    ä É1  É  MMNAzxx
 y    y h  É    Ñxx~   É1É  MMMA:y  
x{    }h …h É   y      X|   MMMx{  
 z~ä~ xx~ä    y     : y    M| 5zxx
 y1         É   Ü~      }     yk y  
 y YT | Ñxx~ äÖ  É    É |    }  y  
x{    y }   É[Sy   É  1  y     â{  
 y    y ä      y    Ö   }  Z    y  
 z~äÄÅxxxx~1  y     y    É      zxx
 y T y      ÉZZy     y   É É     y  
 yY  y  S   ä  y  [  y  |   ä   Ry  
 y   y[     |  }  [  y  }    É[[ y  
xÇx~ä}      Üx~9ä~1á ä     1É Çxx
 y    xxÖäÉ   |   É  É9É  [ É É9y  
 y !  ä  } i   }       É    É É  y  
 y    |       1    | [           y  
 ÜxxxxÅxxxxxxxxxxxxÅxxxxxxxxxxxxxá  
                                    
                                    
                                    
                                    
                                    
                                    
